# start=(-1179,77,243)
78,78,78,78,78,78,78,78,78,78,
78,78,78,78,78,78,78,78,78,78,
78,78,78,78,78,78,78,78,78,78,
78,78,77,77,77,78,78,78,78,78,
78,77,77,77,77,77,77,77,78,79,
77,77,77,77,77,77,77,77,77,77,
77,77,77,77,77,78,77,77,77,77,
77,77,77,77,77,78,77,77,77,77,
77,77,77,77,77,77,77,77,77,77,
77,77,77,77,77,77,77,77,77,77,
